1111111111111111111111111111111111111111111111111111111111111111111111111111111111111111111
100000000000000000000000000000000000C000000000000000000000000000000000000000000000000000011
1000P000000000000000000000000000000011C1100000000111111111100000000000000000000000000001111
1000000000000000000000000000000000011111100000000111111111100000000000000000000000000000011
1000000000000000000000000000000000111111100000000000000111100000000000000000000000000000011
1111100000000000000000000000000001110111100000000000000111100000000000000000000000000001111
1000C00000000000000000000000000011100111100000000111111111100000000000000000000000011111111
1111111111111111111110000000000111000111100000000111111111100000000000000000000000001111111
1000000000000000000000000000001111111111111100000111100000000000000000000000000000000000C11
1000000000000000000000000000011111111111111100000111100000000000000000000000000000011111111
1111111111111111111000000000000000000111100000000111111111100000000000000000000011111111111
1011000000000000000000000000000000000111100000000111111111100000000000000000000000000001111
1110000000000000000000000000000000000000000000000000000000000000000000000000000000000001111
1100000000000000000000000000000000000000000000000000000000000000000000000000000000011111111
1111000000000000000000000000000000000000000000000000000000000000000000000000000000001111101
1111110000000000000000000000000000000000000000000000000000000000000000000000000000000111111
1100000000000000000000000000000000000000000000000000000000000000000000000000000000000001111
1100000000000000000000000000000000000000000000000000000000000000000000000000000000000000111
1110000000000000000000000000000000000000000000000000000000000000000000000000000000000000011
1100000000000000000000000000000000000000000000000000000000000000000000000000000000000111111
1111000000000000000000000000000000000000000000000000000000000000000000000000000000011111111
1111110000000000000000000000000000000000000000000000000000000000000000000000000000111101101
1111111111111111111111111111111111111111110000000000000000000000000000000000000000111111111
11110000000000E0000000000000000000000000000000000000000000000000000000000000000100C00000011
1111111111111111111111111111111111111111111111111111111111111111111111111111111111111111111
1111111111111111111111111111111111111111111111111111111111111111111111111111111111111111111
