11111111111111111111111111111111111111
100000000000000000000000000000000000C1
1000P000000000000000000000000000001111
10000000000000000000000000000000000001
10000000000000000000000000000000000001
111110000000000000000000000U0000111111
1000E000000000000000000000000000000C01
11111111111111111111111111111111111111