11111111111111111
10000000110000001
1000001C110000001
1000011111001E111
10P00000000011111
11111111111111111
11111111111111111
