11111111111111111111111111
10000000000000000000000001
100000000000000000000000C1
10000000000000000001111111
10011110000000000000000001
10000000001110000000000001
100000P0000000000000C00001
10000000000000000000000001
10000000000010000000000001
10000000000000001000000001
10000000110000000000000001
100000001100000C0000000E01
11111111111111111111111111