1111111111111111111111111111111111111111111
1000000011000000000000000000000000000000011
1000001C110000001000000000000000C0000000011
1000011111001E11100000000000000000000000011
10P0000000001111100000000000000000000000011
1111111111111111100000000000000000000000111
1111111111111111111111111111111111111111111
