111111111111111111111
1000000000000000C1101
100000000000000110001
1000P000U000000000001
10C000000000000000001
10000000000E111111111
111111111111111111111
