11111111111111111
10000000110000001
1000000C110000001
1000011111000E111
10P00000000011111
11111111111111111